11111111
00111100
00222200
00222200
00133100
12333321